XXXXXXXXXXXXXXXXXXX
X.......O.O.......X
X.X.X.X.X.X.X.X.X.X
X.X.X.X.X.X.X.X.X.X
X..................X
X.X.X.X.X.X.X.X.X.X
X....F....P....F...X
X.X.X.X.X.X.X.X.X.X
X.X.X.X.X.X.X.X.X.X
X..................X
X.X.X.X.X.X.X.X.X.X
X...r.p.b.o.f.F....X
X.X.X.X.X.X.X.X.X.X
X..................X
X.X.X.X.X.X.X.X.X.X
X.......O.O.......X
XXXXXXXXXXXXXXXXXXX
