XXXXXXXXXXXXXXXXXXX
Xf.......X.......fX  
X.XX.XXX.X.XXX.XX.X
X....r..d.........X
X.XX.X.XXXXX.X.XX.X
X....X...f...X....X  
XXXX.XXXX.X.XXXXXXX
X....X..v....X.b..X
XXXX.X.XX.XX.X.XXXX
X.........p........X
XXXX.X.XXXXX.X.XXXX
X....X...f...X.....X
XXXX.X.XXXXX.X.XXXX
X..c.....X........X  
X.XX.XXX.X.XXX.XX.X
X..X.....P.....X..X
XX.X.X.XXXXX.X.X.XX
X....X...X...X....X
X.XXXXX.XX.XXXXXX.X
Xf...c..o........fX
XXXXXXXXXXXXXXXXXXX