XXXXXXXXXXXXXXXXXXX
X.....O.....O.....X
X.XXX.XXX.X.XXX.XXX
X.F...............X
X.XX.X.XXXXX.X.XX.X
X...X...f...X...X.X
X.X.X.X.X.X.X.X.X.X
X.X.X.X.X.X.X.X.X.X
X.r.p.b.o.......F.X
X.X.X.X.X.X.X.X.X.X
X.X.X.X.X.X.X.X.X.X
X...F....P....F...X
X.X.X.X.X.X.X.X.X.X
X.X.X.X.X.X.X.X.X.X
X...X...f...X...X.X
X.XX.X.XXXXX.X.XX.X
X.F...............X
X.XXX.XXX.X.XXX.XXX
X.....O.....O.....X
XXXXXXXXXXXXXXXXXXX
