XXXXXXXXXXXXXXXXXXX
Xf.......X.......fX  
X.XX.XXX.X.XXX.XX.X
X.................X
X.XX.X.XXXXX.X.XX.X
X....X...f...X....X  
XXXXFXXXX.X.XXXXXXX
OOOO.X.......X.OOOOO
XXXX.X.XXrXX.X.XXXX
O.F....bp.o.......O
XXXX.X.XXXXX.X.XXXX
OOOO.X...f...XFOOOO
XXXX.X.XXXXX.X.XXXX
X........X........X  
X.XX.XXX.X.XXX.XX.X
X..X.....P.....X..X
XX.X.X.XXXXX.X.X.XX
X....X...X...X....X
X.XXXXXFXX.XXXXXX.X
Xf...............fX
XXXXXXXXXXXXXXXXXXX